1.用户体验指标:
首屏时间: 浏览器显示第一屏主页面的消耗时间。首屏的定义 以1024X768像素尺寸为标准。从开
始监测开始计时,到IE浏览器页面显示高度达到768像素且此区域有内容显示之后的时间。
首页打开时间: 首页打开时间是指,打开一个网页的总消耗时间,即从DNS解析开始到浏览器返回
完成时的时间。
首页打开成功率: 首页打开成功率是指成功打开网页次数与总访问次数的比值。
DNS时间: 通过域名解析服务(DNS),将指定的域名解析成IP地址的消耗时间。
建连时间: IE浏览器和Web服务器建立TCP/IP连接的消耗时间。
首包时间: 首包时间是指浏览器从发送HTTP请求结束开始,到接收到Web服务器返回的第一个数据包
的消耗时间。
延时: 延时是指一个报文或分组从一个网络的一端传送到另一个端所需要的时间。
丢包率: 丢包率是指测试中所丢失数据包数量占所发送数据组的比率。

2.云计算性能与可用性指标:
System-CPU使用率: 系统执行系统进程占用CPU的比例。
User-CPU使用率: 系统执行用户进程所占用CPU比例。
Stolen CPU usage: 服务器资源泄漏所占用的CPU比例(此项指标过高说明服务器出现了资源隔
离的问题)。
IO wait CPU使用率: 系统在执行io操作时所占用的CPU比例。
数据库响应时间: 数据库5种SQL操作(INSERT、UPDATE、SELECT、DELETE、CALL)的平均响应时
间。
磁盘IO-读速率: 每秒进行读(I/O)操作的大小。
磁盘IO-写速率: 每秒进行写(I/O)操作的大小。
服务器响应时间: 应用服务器从收到请求到返回响应的时间。
系统负载: 系统CPU繁忙程度的度量,即有多少进程在等待被CPU调度。

3.云计算易用性指标:
数据服务: 数据服务是指云厂商对数据处理组件支持能力的体现。
监控: 监控是指云厂商对用户所选服务器运行状况的监控性能。
弹性伸缩: 弹性伸缩是指云厂商针对用户需求和策略自动调整其弹性计算资源的管理服务。
网络: 网络是指云厂商基础设施中的网络建设情况。
存储: 存储是指云厂商对与存储服务的支持情况。
计算实例: 计算实例是指云厂商服务器支持情况及其基础设施建设情况。
技术支持与服务: 技术支持与服务是指云厂商对用户所提供的支持及服务水平的情况。
